C 65,200,111
F 188,152,90

NO ./sprites/obsidian.xpm
SO ./sprites/quartz.xpm
WE ./sprites/endstone.xpm
EA ./sprites/test.xpm

           1111110
11111111111000000111111111111111
100000000000011111110100000000011
111000000001000000000000000000001
100000000001000000000000000111111
100100000000000000000000000000001
100100000000000000000000000000001
1000000000000000000000000000000000
1000000000000000000100000000000001
100000000000000000000000000000001
100000000000000000000000000000001
1111111111111111111111111111111111
